+---+---+---+---+---+---+---+---+---+---+---+---+---+---+---+---+---+---+---+---+
    |                       |                   |           |       |           |
+   +---+---+---+---+   +   +---+   +---+   +   +   +---+   +---+   +   +---+---+
|       |       |   |   |   |       |       |   |   |   |       |   |           |
+---+   +   +   +   +   +   +   +---+   +---+---+   +   +---+   +   +---+---+   +
|   |       |       |   |       |       |           |   |   |   |   |           |
+   +---+---+   +   +   +---+---+   +---+   +---+---+   +   +   +   +   +   +---+
|               |   |   |       |   |       |           |       |   |   |   |   |
+---+---+   +---+   +   +   +   +   +   +---+   +---+---+   +---+   +   +   +   +
|       |       |       |   |       |   |   |       |       |           |       |
+   +   +---+   +---+---+   +---+   +   +   +   +   +   +---+   +   +---+---+   +
|   |       |           |       |       |       |               |   |       |   |
+   +---+---+---+---+   +---+   +---+---+---+   +---+   +---+---+   +   +   +   +
|   |       |           |       |           |   |   |           |       |   |   |
+   +   +   +   +---+---+   +---+---+---+   +   +   +---+---+   +   +---+   +   +
|       |       |           |               |       |       |   |   |       |   |
+---+---+   +---+   +---+---+   +---+---+---+---+---+---+   +   +---+   +---+---+
|               |       |       |   |           |           |       |           |
+   +---+---+---+---+   +   +---+   +   +---+   +---+   +   +---+   +---+---+   +
|                   |       |           |               |           |            
+---+---+---+---+---+---+---+---+---+---+---+---+---+---+---+---+---+---+---+---+
