+-+-+-+-+-+-+-+-+-+-+-+-+-+-+-+-+-+-+-+-+-+-+-+-+-+-+-+-+-+-+-+-+-+-+-+-+-+-+-+-+-+-+-+-+-+-+-+-+-+-+-+-+-+-+-+-+-+-+-+-+-+-+-+-+-+-+-+-+-+-+-+-+-+-+-+-+-+-+-+-+-+-+-+-+-+-+-+-+-+-+-+-+-+-+-+-+-+-+-+-+
            |     |   |   |         |     |   |   |   |   |         | |               |           |   |     |   |         |       | |     | |   |     |   |       |   |   |   |   |     |       |       |
+ +-+-+-+ + + +-+ +-+ + + + +-+-+ + + +-+ + +-+ + + +-+ + + +-+ +-+ + + +-+-+-+-+-+-+ + +-+-+-+-+ + + +-+-+ + + + +-+-+-+ + +-+-+ + + +-+ + + + +-+-+ +-+ + +-+-+ + + +-+ + + + +-+ +-+ + +-+ + +-+ +-+-+
| |     | |   | | |   | |     |   |   |   |     | |   | |   |   |   |       |   |   | |   | |   | | |   |   | |   |       |   |   |   |     | |       |   | |     | |       | |     | | |   | |   |     |
+ +-+ + +-+-+-+ + + + +-+-+-+ + +-+-+-+ +-+ +-+-+ +-+ + +-+-+-+-+ +-+-+-+-+ + + + + + +-+ + + +-+ + +-+ + +-+ +-+-+ +-+-+ + +-+ +-+-+-+-+ + + +-+ +-+-+ +-+ +-+-+-+ +-+-+ +-+ +-+-+-+ + +-+ + +-+ +-+-+ +
|   | |   |         |         |   |   |   | |   |   | |   |       |   |   |   | | | |   | | | |   |   | |   | |     |   | |   | |   |   | |   |   |     | | |       |     | | |   |   | |   |   |       |
+-+ + +-+ + +-+-+-+-+-+-+-+-+-+-+ + +-+-+ +-+ +-+-+ + +-+ + +-+-+-+ + + + +-+-+-+ + +-+ + + + + +-+-+ + +-+ + + +-+-+-+ + +-+ + +-+ + + + +-+-+-+-+ +-+-+ + + + +-+-+-+-+-+ + + + + +-+ +-+-+-+ +-+-+-+ +
| | | |   |   |     |     |   |   |   | |   |   | |   | | |   |   | |   | |       |     | | | | |     | |     |     |   |     |       | |   |   |     |   |   |         | |     | | |     |   | |     | |
+ + + +-+-+-+-+ +-+ + +-+ + + + +-+-+ + +-+ +-+ + + +-+ + +-+ + + + + +-+-+ +-+-+-+-+-+-+ + + + + +-+-+ + +-+-+-+-+ + + +-+-+-+-+-+ +-+ +-+ + + +-+ + +-+ +-+-+-+ +-+-+ + +-+-+-+ + + +-+ + + + + +-+ + +
| | |   |       | | |   |   | | |   |   |   |     |     | |   | | | | | |   |   |         | |   |     |   |       |   |   |       | |   | | | |   | |   |         |     |   |   | | |   |   | | | |     |
+ + +-+ + +-+-+-+ + +-+ +-+-+-+ + + +-+ + +-+-+ + +-+-+ + + +-+ + +-+ + + +-+ + + + + +-+-+ +-+-+-+-+ +-+-+ +-+-+-+-+-+-+ + +-+-+ + + +-+ + +-+ + +-+-+ +-+-+-+-+-+ +-+-+-+ +-+ + + +-+ + +-+-+ + +-+ +-+
| | | | | |         |     |     | |   | | |   | | |     | |     |     | |   | |   | | |   |   |     |   |             | | | |   |   |   |     | |     | |         |   |     |   | | |   | | |   | |   | |
+ + + + + + +-+ + +-+-+ + + +-+-+ +-+ + + + + + +-+ +-+-+ +-+-+-+-+-+-+ +-+ + +-+-+ + +-+ +-+ + +-+-+-+ + +-+-+-+-+-+ + + + + + +-+-+ +-+-+-+ +-+-+-+ + + +-+-+-+ +-+ + +-+-+ +-+ + +-+-+ + + +-+-+ +-+ +
| |     | | |   | | |   | | |     |     | | |   |   |       | |   |   |   |   |     |     | | | |     | |       |   |     |   | |   |   |   |     |   | | |   |       |     | |     |   | |   |   |     |
+ + + +-+ + + +-+ + + +-+ + + +-+-+-+-+-+ + + +-+ +-+ +-+-+ + + + + +-+ + + +-+ +-+-+-+-+-+ + + + + + + +-+-+-+ + + +-+-+-+-+-+ + + +-+ + + +-+-+ + +-+ +-+ + +-+ + +-+-+-+ + +-+-+-+ + + + +-+ + +-+-+ +
| | |   | | |   | | |   | | |   |       | | |   |   |   |   |   |   |   | |   | |     |   | | |   | | |   |   |   | |       |     | |   | |     |     | |   |   | |   |   | |   |   | |   |     |   |   |
+ +-+-+ + + +-+ + + +-+ +-+ + + + +-+-+ + + + +-+-+ +-+ +-+-+-+-+-+ + + +-+-+ + +-+-+ + + + + +-+-+ + +-+ + + +-+-+ +-+ +-+ +-+-+-+ + +-+ +-+-+ +-+ + + + + +-+ +-+-+ +-+ + +-+ + + + +-+-+-+-+-+-+ + +-+
|   |   | |   | |   | |     | | | |   |   | | |   | |   |   |     | | | |   | |     | | | | |       |   | | |     |   |   | |   |   |     |   | |   |     | |   |   |   | |   | | | |     |     |   | | |
+-+ + +-+ +-+ +-+-+-+ + +-+-+ + + + + +-+-+-+ + + + + +-+ + + + +-+ + + + + + +-+-+ + + + + +-+-+-+-+ +-+ +-+-+-+ +-+ +-+-+ + + + +-+-+-+-+ + + + +-+-+-+-+-+ +-+ + +-+ + +-+ + + +-+-+-+ +-+-+ + +-+ + +
| |   |   | |   |   | | |   | |   | |   |   | | |   | |   |   | |   | |   |   |   | | | |   |   |         |     | | |   |   | | | |   |     | | |   |   | |   |   |   | |   | |     | |   |   | | |     |
+ +-+ + +-+ +-+ + + + +-+ + + +-+-+ + +-+ + + + +-+-+ +-+ +-+-+ + +-+ +-+-+-+-+-+ + + + +-+-+ +-+ +-+ + +-+ +-+ + + +-+ + +-+ + + + + + +-+-+ + + + + + + + +-+ +-+ + + +-+ + +-+-+ + + +-+ + + + + +-+-+
|   |   |   | | | | |   | |   |     |   | |   |     |   | |   | |       |     |     | | |   | |   |   |   | | | | | |         | |   | |     |   | | | |   | |   |   | |   | |   |   |   |   |     |     |
+ + + +-+ +-+ + +-+ +-+ + +-+-+ +-+-+-+ + +-+-+-+-+ +-+ + + +-+ +-+-+ + + +-+ + +-+-+ + +-+ + + +-+ +-+-+ + + + + + +-+-+-+-+-+-+-+-+ +-+-+ +-+-+ + + + +-+ + +-+ +-+-+-+ + +-+ + +-+ +-+ +-+-+-+-+-+-+ +
| | |     |   |   | |   |       |   | |   |       |   |   |   |   |   | | |   |   |   |   | |   |   |   | | |   | | |     |           |   |       |   |   | | |   |     | | |   | |   |   |     |       |
+ + +-+-+-+ +-+-+ + + + +-+-+-+-+ + + +-+-+ +-+-+ + + +-+-+ + + + + +-+ +-+ + +-+ + +-+-+ + +-+-+ +-+ + +-+ + +-+ + + + + + +-+-+-+-+-+-+ +-+-+-+-+-+-+-+-+ + + +-+ + +-+ + + +-+ + +-+ +-+ +-+ + +-+-+-+
| | |               | |       |   | |     | |     | |   |   | | |   |     | |   |   |   |   |   | |   |     |     |   | | |       |     | |     |           | |     |       |     | | | |     | |   |   |
+ + + +-+-+ +-+-+ +-+-+-+-+-+ + +-+ +-+ +-+ + +-+-+ +-+ + +-+ + +-+-+-+ + + +-+-+-+-+ + + +-+ + + + +-+-+ +-+-+ +-+-+-+ + +-+-+-+ + +-+ + + +-+ + +-+-+-+-+-+ +-+-+ +-+-+-+ + +-+-+ + + +-+-+ + +-+ +-+ +
| | | |     |   | | |       | | | | |       | |     | | |   | |   |     | | |       | |   |   | | | |   | |   |       | | |   | |   |   | | |   |           |     | |   |   |   |   |   |     |   |   | |
+ + +-+ +-+-+ + + + + +-+-+ + + + + +-+ +-+-+ +-+-+-+ + + + + +-+ + +-+-+ + + +-+-+ + +-+-+ +-+-+ + + + +-+ + +-+-+-+ + + +-+ + +-+-+ +-+ + +-+-+-+-+-+-+-+ +-+-+ + +-+ + +-+ + + + + +-+ +-+ +-+-+-+ + +
| | |   |   | | |   |     | | |   |   |     |   |   | | | | |     |     | | |   |   | |   | |     |   |   | |     |   | |   |   |     |   | |               | |   | |   | |   |   | | | |   |     |   | |
+ + + +-+ + + + +-+ +-+-+-+ + +-+ +-+ + +-+-+-+ + + + + + + +-+-+-+-+ + + + + + + +-+ + +-+ + +-+ +-+-+-+ + +-+-+ + +-+ +-+ + +-+ + +-+ +-+ + +-+-+-+-+ +-+-+ + + + + +-+ + +-+-+-+-+ + +-+-+-+-+ + + + +
| |   |   | | | |   |     |     |   | |       |   |   | | | |       | | | |   | |     |       |   |   | | | |     | |   |   |   | |   |   |   | |   | |     |   | | |   |   |       | |         | | | | |
+ +-+-+-+-+ + + +-+-+ +-+ +-+ + +-+ + +-+-+-+ + +-+ +-+ + + + +-+-+ + + + +-+-+ +-+-+-+-+ + +-+ +-+ + + + + +-+-+-+ + +-+-+ +-+ + +-+ +-+ +-+-+ + + + +-+ +-+-+-+ + +-+ +-+-+-+-+-+ + + +-+-+-+ + +-+ + +
|   | |     | |         | |   |     |     |   |   |       | | |   |   | | |     |     |   |   |   | |     |   | |     |     |     |   |       |   | |   |     |   | |     | |   |   | | |     | |     | |
+-+ + + + + + +-+-+-+-+-+ + +-+-+-+-+-+ + +-+ +-+-+-+-+-+-+-+ +-+ +-+-+-+ +-+ +-+-+ + + +-+-+-+-+ + + + +-+-+ + + +-+-+ +-+-+-+-+-+ +-+ +-+-+ +-+-+ +-+ +-+-+ + +-+ + +-+ + + + + +-+ + + +-+ + +-+-+ + +
|   |   | |   |           | |         | | |   |   |     |   |   | |     | |   |   | | |       | | | | | |   | |   |         |   |   |   |   | |   |   |   |     | |   |   |   | |   | | |   | |   | |   |
+ +-+ +-+-+-+-+-+ +-+-+-+-+ +-+-+-+-+ + +-+ +-+ + + +-+ + + +-+ + +-+-+ + + +-+-+ +-+ +-+-+-+ + + +-+ + + + + +-+ + +-+-+-+-+ + + +-+ +-+ + + +-+ +-+ +-+ + + +-+ +-+-+ +-+-+-+ +-+ + + +-+ + +-+ + +-+ +
|   |   |     |   |   |   |         | |       | |   |   | | |   | |   | |   |   |   | |     |   | |   | | | |     |   |     | | |     |   | | |   |   | | | | | |       |     |   |     |   |   | |   | |
+-+ +-+-+ +-+ + +-+ + + +-+-+-+-+-+ + +-+-+ + + +-+-+ +-+ + + +-+ + + + + +-+ + +-+ + +-+ + +-+-+ + +-+-+ + +-+-+-+-+ + +-+ + + +-+-+-+ +-+ + + +-+-+ + + + + + +-+ +-+-+-+ + +-+ +-+-+-+ +-+ + + +-+ +-+
| |   |   |   |   | |       |   |   |       | |   | | |   |   | |   |   |   | | |   |   | |       | |     |           |   |   | |       | |   |       | |   | |   | |       |   | |     |   | |     |   |
+ + + + +-+ +-+-+ + +-+ +-+ +-+ + +-+-+-+-+-+ +-+ + + + +-+-+-+ +-+-+ +-+-+ + + + +-+ + +-+ +-+-+-+ + +-+-+-+ +-+-+-+-+-+ +-+-+ + +-+-+-+ +-+-+ + +-+-+ +-+-+ + +-+ + +-+-+-+ + + + +-+ + + + + + +-+-+ +
| | |   |   |   |     | |   |   | |   |   |   |   | | |     |     |   |   | | | | |   |     |     | |       |   |   |   |   | | |     |       | | |       |   | |     |     | |   |   |   | | | |       |
+ +-+-+-+ +-+ + +-+-+ + + +-+ +-+ + +-+ + + +-+ + + + + +-+-+ + +-+ +-+ + + + + + + + +-+-+-+ +-+ + +-+-+-+ +-+ +-+ +-+ +-+ + + +-+-+ + + + +-+ +-+ +-+-+ + +-+ + + +-+ +-+ +-+-+-+-+ +-+-+-+ + +-+-+-+-+
|       | |   | |     | |     | | | |   |   |   | |   |   |   | |   |   |   | |   | |       |   |   |     | |   |       |   |   |   |   | |       | |   |   | | | | |   |   |   |   |       | |   |     |
+-+-+-+ + + +-+ +-+-+-+ +-+-+-+ + + + +-+-+ + +-+-+-+-+-+ + + + + +-+-+-+-+-+ +-+ + +-+-+-+ +-+ + +-+-+-+ + + +-+ + +-+-+ + +-+ + + +-+-+ + +-+-+ + +-+ +-+-+ + + + + +-+ +-+ +-+ + +-+-+-+ + +-+ +-+-+ +
|   | | |   |   |     |       | |   |   | |   |     |     | | | |         | | |   | |   |   |   | |     |   | |   |     | | | |   | |     |     | |   |   |       |   |   |   |   | |   |   | |   |     |
+ + + + +-+-+ +-+ +-+ + +-+-+ + +-+ +-+ + +-+-+ +-+ + +-+-+ + +-+-+-+-+-+ + + + +-+ + + + +-+-+-+ +-+-+ +-+-+ + +-+-+-+ +-+ + +-+-+ + +-+-+-+-+ +-+-+ +-+ + +-+-+-+-+-+ + + + + +-+-+ + + +-+ + +-+ +-+ +
| |     |     |   | | |     |   |   |   |     | |   |   |   | |   |   | | | | | |   | | |       |     | |   | | |   |       | |   | |   |     | |   |     |       | |   |   | |       |   |   | |   |   |
+ +-+-+-+-+ +-+-+-+ + +-+-+-+-+ + +-+ +-+-+-+ +-+ +-+-+ + +-+ + + +-+ + + + + +-+ +-+ + +-+-+-+ +-+ + + + + + + + +-+ + +-+-+ + + + +-+ + +-+-+ + + +-+-+-+-+-+-+ + + +-+-+-+-+-+ +-+-+-+-+ +-+-+ +-+-+ +
|   |   |     |   | |   |     | | | |   |   | |   |   | | |   | |         |   |     | |   |   |   | | |   | |   |     | |   | | |   |     |   | | |     |   |   | |     |       | |     |   |   | |   | |
+-+ +-+ + +-+ + + + +-+ + +-+ + + + + + + + + + +-+ + + + +-+-+ + +-+-+-+-+ +-+ +-+-+ +-+ + + + + + +-+-+-+ +-+-+-+-+-+ + + + + +-+-+ + +-+ + + + +-+-+ + + +-+ + +-+ + +-+ +-+ + + +-+ + + +-+ + + + + +
| |       |   | | |     | |   | |   | | | |   | |   | | |       |   |   |   |   |     |   | |   | |     |   |       |   | | | |     | |     | | |     | | |     | |   | |   | | | | | |   |       | |   |
+ +-+-+ +-+-+-+ + +-+ +-+ + +-+ + +-+-+ + + +-+ +-+ + + +-+-+ +-+-+ + + +-+ + +-+ +-+-+ +-+ +-+-+-+-+-+ + +-+-+-+-+ + +-+ +-+ +-+-+ +-+-+-+-+ + +-+-+ + + +-+-+-+ + +-+ + +-+ + +-+ + +-+-+-+-+-+-+ +-+-+
|   |   |   |   |   | |   | |   | |     | |   | |   | | |   | |   | | | |   | | |   |   |   |     |   | |     | |   |     |   |     |         | |   | | | |       |   |   |   |     |         |       | |
+ + + +-+ + + +-+-+ + + +-+ + +-+ + +-+-+ +-+ + + +-+ + +-+ +-+ + + + + + +-+ + + +-+ +-+-+ + +-+ +-+ + +-+-+ + + + +-+ + + +-+ +-+-+ +-+-+-+-+ + + + + + + +-+-+-+-+ +-+-+-+ + +-+-+-+ +-+-+-+ +-+ + + +
| | | |   |   |     | | | | |     | |   |   |   |   |       |   |   | | | |     |   |     | | |   |     |   |   | | |   | |     |   |     |   | | | | | |   |   |     |   |     |     |         |   |   |
+ +-+ + +-+-+-+ +-+-+ + + + + +-+-+ + + +-+ +-+-+-+-+-+ +-+ + +-+-+-+ +-+ + + +-+-+ +-+-+ + + + +-+ +-+-+ + + +-+ + +-+-+ +-+-+-+ + +-+-+ + + + + + + +-+ +-+-+ + +-+-+ + + +-+-+ +-+ + +-+-+-+-+ +-+ +-+
| |   |   |   | |   |     |   |   | | | |               | | | |           | | |   |   |   |   |   | |     |   |   |       |   |   |     | | | |   | |           | |   | | |     | |     |       | | |   |
+ + +-+ + + +-+ + + +-+ + + +-+ + + +-+ + +-+-+-+-+-+-+-+ + + + + +-+ +-+-+ + + + + + + +-+-+-+-+ + +-+ +-+-+-+ +-+-+-+-+-+ + + +-+-+-+ + + + +-+-+ +-+-+ +-+-+-+ + + + + +-+-+-+ +-+-+-+ +-+ + + + +-+ +
|   |   | | |   | |     | |   | | |     |     |         |     | | |   |   | | | | | | |   | |       |   |     |     |       | |   |   |   | |     | | |   |     |   | | |         |   |   |   | | |     |
+ +-+-+-+ + + +-+-+-+-+-+ + +-+ +-+-+ +-+-+-+ + +-+-+-+ +-+ +-+ + + +-+ + + + +-+ + + +-+ + + +-+-+-+ +-+-+-+ +-+-+ + +-+-+-+-+-+ +-+ +-+-+ +-+-+ + + + +-+ +-+ + +-+ + +-+-+-+-+-+ +-+ +-+ + + + +-+-+ +
| |   |   | |             |   |   |   |       |       | |   |   | |     | | |     | |   | |   |   |   |   | | | |   |     |   | |   | |     |       | |   | |   |   | |       |   |   | |   | |     |   |
+ + + + +-+ +-+ +-+-+-+-+-+-+ +-+ + +-+ +-+-+-+-+-+-+ + + +-+ +-+ +-+-+-+ + +-+-+-+-+-+ + +-+-+ + + +-+-+ + + + + +-+-+ +-+ + + +-+ + + +-+-+-+-+-+-+ +-+ + +-+-+-+ + +-+-+-+ + +-+ + + +-+-+-+-+-+-+ +-+
| | | | |       |   |         |     |   |     |   |   |   |   | |   |     |         |   |   |   |     |   | | |   |   |     |   |   | |   |           |   |   |     | |     | |     | |   |   |   |   | |
+ +-+ + +-+-+-+-+ + + +-+-+-+-+-+-+-+ +-+ + + + + + +-+-+-+ +-+ + + + +-+-+ +-+-+-+ + +-+-+ + +-+-+-+ + +-+ + +-+ +-+ +-+-+-+-+ + +-+ +-+ + +-+-+-+-+ + +-+-+ +-+-+-+ +-+-+ + +-+-+-+ +-+ + + + + + +-+ +
|   | | |   | |   |   |         |   | |   | |   |   |     | |   | | |       |     | | |     | |       | |       | |   |     |   |   | |   |   |     |   |   |         |   |     |   |     | |   | |   | |
+-+ + + + + + + +-+-+-+ + +-+-+ + +-+ + +-+-+-+-+-+-+ +-+ + + +-+-+ +-+ +-+-+ +-+ + + + +-+-+ + +-+-+ + +-+-+ + + + +-+ +-+ + +-+-+ + + +-+-+ +-+-+ +-+-+ + +-+-+-+-+-+ + +-+ +-+ + +-+-+-+ +-+ + +-+ + +
| | | | | |   |   |   | | |   | |   | | |   |         |   | |       |   |   |   | |   | |     | |     |     | | | |   |   | |     |   | |   |     |       |     |   | | |     |   |     | | |   |     | |
+ + + + + +-+-+-+ + +-+ + + + +-+-+ + + + + + +-+-+-+-+ +-+ +-+-+-+ + +-+ + +-+ +-+-+-+ + +-+-+ + +-+-+-+ + + + + + +-+-+ +-+-+-+ +-+-+ +-+ +-+-+ +-+-+ +-+-+-+ + + + + +-+-+-+ +-+-+-+ + + +-+-+-+-+-+ +
|     | |   |   | |     |   |   | |   | | | |         | |   |   |   |     | | |         |   | | | |       | | | | |     |           | |         |       |       | |     |     |   |     |         |     |
+-+ +-+ + +-+ +-+ +-+ +-+-+-+ + + +-+-+ +-+ +-+ +-+-+-+ + +-+-+ + +-+-+-+-+ + +-+-+-+-+-+-+ + + + + +-+ +-+-+ +-+ +-+-+ +-+-+-+-+ + + +-+-+-+-+-+-+ +-+-+ +-+-+-+ +-+ +-+-+ + +-+ + +-+-+-+-+ +-+-+ +-+-+
|       | |       |   |       |     | |   | | |   |     | |   | | | |       | |   |     |   |   | |   |   |   |       | |   |     |   |   |       |   |   |   |   |   |     |   | |   |   | | |   |   | |
+-+-+-+-+ + +-+-+-+-+-+ +-+-+-+-+-+ + +-+ + + +-+ + +-+-+ + + + + + + +-+-+-+ + + + +-+ + +-+-+-+ +-+ +-+ + +-+ +-+-+-+ + + + +-+-+-+-+ + + +-+-+ +-+-+ +-+ +-+ +-+-+-+-+ +-+-+ + +-+ + + + + + + +-+ + +
|   |     |     |     |           | |   |         |       | | | |   |         | |     |   |     |     |   |     | |       | | |   | |   | | |   |       | |     |             | | |   | | | | | |     | |
+ + + +-+-+-+-+ + +-+ +-+-+-+ +-+-+ + +-+-+ + +-+-+-+ +-+ + + + +-+-+-+-+ + +-+ +-+-+ +-+-+-+ + +-+-+-+-+-+-+-+-+ + +-+ +-+ + + + + + +-+ + + + +-+-+-+ + +-+-+-+ +-+-+-+-+-+-+ + +-+-+ + + + + +-+-+-+ +
| | | |         |   |   |   | |     |     | |   |   |   | | |     |       |     |     |   |   | |         |   |   | | | | |     | | |   | |   |   |     |   |     |     |     | |     | |         |     |
+ + + + + +-+-+-+-+ +-+ + + + + +-+-+-+-+ + +-+ +-+ +-+ + + +-+-+ + +-+-+-+-+-+-+ +-+-+ + + +-+-+ +-+-+-+ + +-+ + + + + + +-+ +-+ + + + + +-+-+ + + + +-+-+ + +-+-+-+-+ + +-+ + +-+-+ + +-+ + +-+ + +-+-+
| |     |   | |   |   | | | | |     |   |   | | |   |   | |   | | |     | |   |   |     |   |     |       | |   | | | |   |   |   |   | |   |   | | |       |         |     |   |   |   | | |   | |     |
+-+-+-+-+ + + + + +-+ + + + +-+-+-+ + + + +-+ + + +-+ +-+-+-+ + + +-+-+ + + +-+ +-+ +-+-+-+-+ +-+-+-+ +-+-+ + +-+ + + +-+-+ +-+ +-+-+-+ +-+ +-+-+ + +-+-+-+-+-+-+-+-+ +-+-+-+-+-+ + +-+-+ + +-+ +-+-+-+ +
|       | | |   |     |   |         | |   |     | |           |   |     | |     |   |       | |       |   |     |   |       | | |   |     |   | | |     |           |     |   |   |     |     |       | |
+ +-+-+-+ +-+ +-+-+-+-+-+ +-+-+ +-+-+ +-+-+ + +-+ + +-+-+-+-+-+-+ + + +-+ +-+-+-+ +-+-+-+-+ + + +-+-+-+ + +-+-+ + +-+-+-+-+-+ + + + +-+-+-+-+ + + +-+-+ +-+-+-+-+ + +-+ + + + + +-+-+-+ + +-+-+-+-+-+ + +
| |       |   |   | |     |   | |   |   |   |     | |   |         | | |           |     |   | | |     | |       | |           | | |   |     | |     |   |   |     |   | | | | |       |   |   | |   | | |
+ + +-+-+-+ +-+-+ + + +-+-+ + +-+ + +-+ +-+-+-+-+-+-+ + +-+-+-+-+-+ + +-+ +-+-+-+-+ +-+ + +-+ + + +-+ + +-+-+-+-+-+ +-+-+-+-+-+ + +-+ + + +-+ + + +-+ +-+ + +-+-+-+-+ +-+ + + +-+-+-+ +-+-+ + + + + + + +
|       |   |     | |   | | |     | | | |     |       |   |     |   | |   |     |     |   | | |   | | | |   |     |           |   |   | |     | | |   |   |       | |   | | | |     | |     |   | | | | |
+-+ +-+ + +-+ +-+-+ +-+ + + +-+-+-+ + + + +-+-+ +-+-+-+-+ +-+-+ + +-+ + +-+ + + + + + +-+-+ + +-+-+ + + + + + +-+ +-+-+-+-+ + +-+-+ + + + +-+-+ +-+ +-+ +-+-+-+-+ + +-+ + + + + + + + + +-+-+ +-+ + + + +
|     |   |   |     | |     |       |   | |   | |             |   |   | |   | | | | |   |   |   |   |   | | | | |     |     |       |   |   | |   | |           |   |   |   | | | | |   |   |     | |   |
+-+-+ +-+-+ +-+ +-+ + +-+-+-+ +-+-+ +-+-+ + + + + +-+-+-+ +-+ + +-+ +-+ + +-+-+ + +-+ +-+ + + + + +-+-+-+ + + + +-+-+ +-+-+-+-+-+-+-+-+-+-+ + +-+ + +-+-+-+-+-+ +-+ + +-+-+-+ + + +-+-+-+-+ +-+-+-+ +-+-+
|   | |   | |   | | |     |     | |     |   |   |   | |     | | | |     |   |   | |   |   |   |   |   |   |   |             |   |         |   |   |     |   |     | |       |   |             |   | |   |
+ + + +-+ + + +-+ + + +-+ + + + + +-+-+ +-+ +-+-+-+ + + +-+-+ + + +-+ +-+-+-+ +-+ + +-+ +-+-+-+-+-+ + + +-+-+-+-+-+-+-+-+-+ + + + +-+-+-+ +-+-+ +-+-+-+ + + +-+ + + + +-+-+ +-+-+ +-+-+-+-+-+ + +-+ +-+ +
| | |   | | |     |   | |   | |   | |   | |   |   | | | |   |   |   | |     |   | |   |         |   |   |       |     |     | | | | |     |     |         |   | | | |     |   |   |   |     |       |   |
+ +-+-+ + + +-+-+ +-+ + +-+-+-+-+ + + +-+ +-+ + + + + + + + +-+ +-+ + + +-+ +-+ + +-+ +-+-+-+-+ +-+-+ +-+ +-+-+ +-+-+ +-+ +-+-+ + + + +-+-+-+-+ + +-+-+-+-+-+ + +-+ +-+ +-+-+-+ + + +-+ +-+-+-+ +-+-+ + +
|       | |     |   |   |         |   | |     | | |   | | | | |   |   |   |   | |   | |       |         |   |   |   | |   |   | |   | |         | | |       | | |   | |         | |   |     |     |   | |
+-+-+-+-+ +-+-+ +-+-+-+-+ +-+ +-+-+-+-+ +-+-+-+ + +-+-+ + + + +-+ +-+-+-+ +-+ + +-+ + +-+-+-+ +-+-+ +-+ +-+-+ +-+ + + + +-+ + + +-+ + + +-+-+-+-+ + + + +-+-+ +-+ +-+ +-+-+-+-+-+-+-+ +-+-+ +-+-+ + +-+ +
|       |     |         |   | |             | | | |     | |   |     |   | |   | |   |       |     |   | |         | | | |   |   |   |   |       | |   |   |   |   |   |         |             |   | | | |
+ +-+-+ +-+ + +-+-+-+ +-+-+-+ + +-+-+-+-+-+ + + + + +-+-+-+-+ + + + + +-+ +-+ + + +-+-+-+-+ + + + +-+ +-+ +-+ +-+-+ + + + +-+-+-+ +-+-+-+-+-+-+ + +-+-+-+ + +-+ +-+ +-+ +-+-+-+ + + +-+-+ + + + + + + + +
| |   |     |       |   | |   |   |   |   |     | |   |   | |   | | |     |     | |     |   | | |     |   |   |     | |   |       |   |   |   | |       | |     |     |       |   | |   | | |   |   |   |
+ + + +-+ +-+-+-+-+ + + + + +-+-+ + +-+ + +-+-+-+ +-+ + + + + +-+ + +-+-+-+ + +-+-+ +-+ + +-+ + +-+-+-+ +-+ +-+ +-+-+ +-+-+-+ +-+-+-+ + + + + + +-+-+-+ + +-+-+-+ +-+-+-+-+-+ +-+-+-+ + +-+ + +-+-+-+-+-+
| | |   | |   | |   | | |     |   |     |   |   | |     | | | |   | |     | |       | |       | |       | | |   |   | |         |   |   | | | | |       | |     |   |   |     |       |   | | |         |
+ + +-+ + +-+ + + + + +-+ +-+ + +-+ + + +-+ + + + +-+-+-+ + +-+ +-+ + +-+-+ + +-+-+-+ +-+ +-+-+-+ +-+-+-+ + + +-+ + + + +-+-+-+-+ + + +-+ + + + + +-+-+-+ + +-+ +-+ + + + +-+-+ +-+-+-+-+ + + + +-+-+-+ +
|   |   |     |   |       |   |     | |   |   | |         |       |         |         |                 |   |     |   |           |   |     |   |         |   |       |   |             |   |   |        
+-+-+-+-+-+-+-+-+-+-+-+-+-+-+-+-+-+-+-+-+-+-+-+-+-+-+-+-+-+-+-+-+-+-+-+-+-+-+-+-+-+-+-+-+-+-+-+-+-+-+-+-+-+-+-+-+-+-+-+-+-+-+-+-+-+-+-+-+-+-+-+-+-+-+-+-+-+-+-+-+-+-+-+-+-+-+-+-+-+-+-+-+-+-+-+-+-+-+-+-+
