+---+---+---+---+---+---+---+---+---+---+
        |   |                       |   |
+---+   +   +   +---+   +---+---+   +   +
|   |   |           |   |   |           |
+   +   +---+---+---+   +   +   +---+---+
|               |       |   |           |
+---+   +---+---+   +---+   +---+   +   +
|       |                   |       |   |
+   +---+   +---+---+---+---+   +---+   +
|           |                   |        
+---+---+---+---+---+---+---+---+---+---+
